{
  "world_name": "",
  "world_author": "",
  "world_description": "",
  "ugcFileId": 0,
  "ugcImagePreviewPath": "",
  "_comment": "Editing this file manually is not advised. If you'd like to change the dimensions of an act, consider consulting ekun.",
  "act_specifications": [
      {
          "_comment": "ACT_ONE",
          "width": 12,
          "height": 8
      },{
          "_comment": "ACT_TWO",
          "width": 12,
          "height": 8
      },{
          "_comment": "ACT_THREE",
          "width": 12,
          "height": 8
      },{
          "_comment": "ACT_FOUR",
          "width": 12,
          "height": 8
      },{
          "_comment": "BRANCH_ONE",
          "width": 12,
          "height": 8
      },{
          "_comment": "BRANCH_THREE",
          "width": 12,
          "height": 8
      },{
          "_comment": "BRANCH_TWO",
          "width": 12,
          "height": 8
      },{
          "_comment": "BRANCH_FOUR",
          "width": 12,
          "height": 8
      },{
          "_comment": "TUTORIAL",
          "width": 12,
          "height": 8
      },{
          "_comment": "INTERMISSION",
          "width": 12,
          "height": 8
      },{
          "_comment": "ARENA",
          "width": 12,
          "height": 12
      },{
          "_comment": "FINAL_FIGHT",
          "width": 12,
          "height": 8
      }
  ],
  "acts": [
      {
          "_comment": "ACT_ONE",
          "rooms": {}
      },{
          "_comment": "ACT_TWO",
          "rooms": {}
      },{
          "_comment": "ACT_THREE",
          "rooms": {}
      },{
          "_comment": "ACT_FOUR",
          "rooms": {}
      },{
          "_comment": "BRANCH_ONE",
          "rooms": {}
      },{
          "_comment": "BRANCH_THREE",
          "rooms": {}
      },{
          "_comment": "BRANCH_TWO",
          "rooms": {}
      },{
          "_comment": "BRANCH_FOUR",
          "rooms": {}
      },{
          "_comment": "TUTORIAL",
          "rooms": {}
      },{
          "_comment": "INTERMISSION",
          "rooms": {}
      },{
          "_comment": "ARENA",
          "rooms": {
              "0": [
                  {
                      "uid": "hurivub",
                      "worldFirstRoom": true,
                      "tiles": [
                          [
                              0,-1,-1,0,-1,-1,0,-1,-1,1,-1,-1,1,-1,-1,209,-1,-1,1,-1,-1,208,-1,-1,1,-1,-1,208,-1,-1,1,-1,-1,208,-1,-1,1,-1,-1,208,-1,-1,1,-1,-1,208,-1,-1,1,-1,-1,208,-1,-1,1,-1,-1,208,-1,-1,1,-1,-1,208,-1,-1,1,-1,-1,208,-1,-1
                          ],[
                              1,-1,-1,210,-1,-1,1,-1,-1,210,-1,-1,1,-1,-1,208,-1,-1,1,-1,-1,208,-1,-1,1,-1,-1,208,-1,-1,1,-1,-1,208,-1,-1,1,-1,-1,208,-1,-1,1,-1,-1,208,-1,-1,1,-1,-1,208,-1,-1,1,-1,-1,208,-1,-1,1,-1,-1,208,-1,-1,1,-1,-1,208,-1,-1
                          ],[
                              1,-1,-1,208,-1,-1,1,-1,-1,208,-1,-1,1,-1,-1,208,-1,-1,1,-1,-1,208,-1,-1,1,-1,-1,208,-1,-1,1,-1,-1,208,-1,-1,1,-1,-1,208,-1,-1,1,-1,-1,208,-1,-1,1,-1,-1,208,-1,-1,1,-1,-1,208,-1,-1,1,-1,-1,208,-1,-1,1,-1,-1,208,-1,-1
                          ],[
                              1,-1,-1,208,-1,-1,1,-1,-1,208,-1,-1,1,-1,-1,208,-1,-1,1,-1,-1,208,-1,-1,1,-1,-1,208,-1,-1,1,-1,-1,208,-1,-1,1,-1,-1,208,-1,-1,1,-1,-1,208,-1,-1,1,-1,-1,208,-1,-1,1,-1,-1,208,-1,-1,1,-1,-1,208,-1,-1,1,-1,-1,208,-1,-1
                          ],[
                              1,-1,-1,208,-1,-1,1,-1,-1,208,-1,-1,1,-1,-1,208,-1,-1,1,-1,-1,208,-1,-1,1,-1,-1,208,-1,-1,1,-1,-1,208,-1,-1,1,-1,-1,208,-1,-1,1,-1,-1,208,-1,-1,1,-1,-1,208,-1,-1,1,-1,-1,208,-1,-1,1,-1,-1,208,-1,-1,1,-1,-1,208,-1,-1
                          ],[
                              1,-1,-1,208,-1,-1,1,-1,-1,208,-1,-1,1,-1,-1,208,-1,-1,1,-1,-1,208,-1,-1,1,-1,-1,208,-1,-1,1,-1,-1,208,-1,-1,1,-1,-1,208,-1,-1,1,-1,-1,208,-1,-1,1,-1,-1,208,-1,-1,1,-1,-1,208,-1,-1,1,-1,-1,208,-1,-1,1,-1,-1,208,-1,-1
                          ],[
                              1,-1,-1,208,-1,-1,1,-1,-1,208,-1,-1,1,-1,-1,208,-1,-1,1,-1,-1,208,-1,-1,1,-1,-1,208,-1,-1,1,-1,-1,208,-1,-1,1,-1,-1,208,-1,-1,1,-1,-1,208,-1,-1,1,-1,-1,208,-1,-1,1,-1,-1,208,-1,-1,1,-1,-1,208,-1,-1,1,-1,-1,208,-1,-1
                          ],[
                              1,-1,-1,208,-1,-1,1,-1,-1,208,-1,-1,1,-1,-1,208,-1,-1,1,-1,-1,208,-1,-1,1,-1,-1,208,-1,-1,1,-1,-1,208,-1,-1,1,-1,-1,208,-1,-1,1,-1,-1,208,-1,-1,1,-1,-1,208,-1,-1,1,-1,-1,208,-1,-1,1,-1,-1,208,-1,-1,1,-1,-1,208,-1,-1
                          ],[
                              1,-1,-1,208,-1,-1,1,-1,-1,208,-1,-1,1,-1,-1,208,-1,-1,1,-1,-1,208,-1,-1,1,-1,-1,208,-1,-1,1,-1,-1,208,-1,-1,1,-1,-1,208,-1,-1,1,-1,-1,208,-1,-1,1,-1,-1,208,-1,-1,1,-1,-1,208,-1,-1,1,-1,-1,208,-1,-1,1,-1,-1,208,-1,-1
                          ],[
                              1,-1,-1,208,-1,-1,1,-1,-1,208,-1,-1,1,-1,-1,208,-1,-1,1,-1,-1,208,-1,-1,1,-1,-1,208,-1,-1,1,-1,-1,208,-1,-1,1,-1,-1,208,-1,-1,1,-1,-1,208,-1,-1,1,-1,-1,208,-1,-1,1,-1,-1,208,-1,-1,1,-1,-1,208,-1,-1,1,-1,-1,208,-1,-1
                          ],[
                              1,-1,-1,208,-1,-1,1,-1,-1,208,-1,-1,1,-1,-1,208,-1,-1,1,-1,-1,208,-1,-1,1,-1,-1,208,-1,-1,1,-1,-1,208,-1,-1,1,-1,-1,208,-1,-1,1,-1,-1,208,-1,-1,1,-1,-1,208,-1,-1,1,-1,-1,208,-1,-1,1,-1,-1,208,-1,-1,1,-1,-1,208,-1,-1
                          ],[
                              1,-1,-1,208,-1,-1,1,-1,-1,208,-1,-1,1,-1,-1,208,-1,-1,1,-1,-1,208,-1,-1,1,-1,-1,208,-1,-1,1,-1,-1,208,-1,-1,1,-1,-1,208,-1,-1,1,-1,-1,208,-1,-1,1,-1,-1,208,-1,-1,1,-1,-1,208,-1,-1,1,-1,-1,208,-1,-1,1,-1,-1,208,-1,-1
                          ]
                      ]
                  }
              ]
          }
      },{
          "_comment": "FINAL_FIGHT",
          "rooms": {}
      }
  ]
}